#!/usr/bin/env pushover

Version
| 1

Name
| 070

Author
| Harry Nadler
| Avril Rigby
| Don Rigby
| Chris Waterworth

Theme
| mechanic

Time
| 5:00

Hint
| Delay another way!

Level
+---------------------
|                  1
|          ?IIIIII___
|                  H
|     IIIIYIII?I   H
|                  H
|   #_IIII    II_#___
|                  H
|   ?????__O*_     H
|        H         H
|     IIIIII_______?_
|                  H2
|   #_IIIII:O= :_!___
|
+---------------------

Background
+--------------------------------------------------------------------------------
|   1   1   1   1   1   1   1   1   1   1   1   1   1   1   1   1   1   1   1   1
|   1   1   1   1   1   1   1   1   1   1   1   1   1   1   1   1   1   1   1   1
|   1   1   1   1   1   1   1   1   1   1   1   1   1   1   1   1   1   1   1   1
|   1   1   1   1   1   1   1   1   1   1   1   1   1   1   1   1   1   1   1   1
|   1   1   1   1   1   1   1   1   1   1   1   1   1   1   1   1   1   1   1   1
|   1   1   1   1   1   1   1   1   1   1   1   1   1   1   1   1   1   1   1   1
|   1   1   1   1   1   1   1   1   1   1   1   1   1   1   1   1   1   1   1   1
|   1   1   1   1   1   1   1   1   1   1   1   1   1   1   1   1   1   1   1   1
|   1   1   1   1   1   1   1   1   1   1   1   1   1   1   1   1   1   1   1   1
|   1   1   1   1   1   1   1   1   1   1   1   1   1   1   1   1   1   1   1   1
|   1   1   1   1   1   1   1   1   1   1   1   1   1   1   1   1   1   1   1   1
|   1   1   1   1   1   1   1   1   1   1   1   1   1   1   1   1   1   1   1   1
|   1   1   1   1   1   1   1   1   1   1   1   1   1   1   1   1   1   1   1   1
+--------------------------------------------------------------------------------

Background
+--------------------------------------------------------------------------------
|   0   0   0   0   0   0   0   0   0   0   0   0   0   0   0   0   0   0   0   0
|   0   0   0   0   0   0   0   0   0   0   0   0   0   0   0   0   0   0   0   0
|   0   0 162 163 163 163 163 163 163 163 163 163 163 163 163 163 163 163 163 163
|   0   0 168 169 169 169 169 169 169 169 169 169 169 169 169 169 169 169 169 169
|   0   0   0   0   0   0   0 162 163 163 163 163 163 163 163 163 164   0   0   0
|   0   0   0   0   0   0   0 168 169 169 169 169 169 169 169 169 170   0   0   0
|   0 162 163 163 163 163 163 163 163 163 163 163 163 163 163 163 163 163 163 163
|   0 168 169 169 169 169 169 169 169 169 169 169 169 169 169 169 169 169 169 169
|   0   0 162 163 163 163 163 163 163 163 163 163 163 163 163 163 163 163 163 163
|   0   0 168 169 169 169 169 169 169 169 169 169 169 169 169 169 169 169 169 169
|   0   0   0   0   0   0   0   0   0   0   0   0   0   0   0   0   0   0  89  90
|   0   0   0   0   0   0   0   0   0   0   0   0   0   0   0   0   0   0  95  96
|   0   0   0   0   0   0   0   0   0   0   0   0   0   0   0   0   0   0  95  96
+--------------------------------------------------------------------------------

Background
+--------------------------------------------------------------------------------
|   0   0   0   0   0   0   0 162 164   0   0 162 164   0   0   0   0   0   0   0
|   0   0   0   0 162 164   0 165 167   0   0 165 167   0   0   0   0  89  91  89
|   0   0   0   0 165 167   0 165 167   0   0 165 167   0   0   0   0  92  94  92
|   0   0   0   0 165 167   0 165 167   0   0 165 167   0   0   0   0   0 162 164
|   0   0   0   0 165 167   0 165 167   0   0 165 167   0   0   0   0   0 165 167
|   0   0   0   0 165 167   0 165 167   0   0 165 167   0   0   0   0   0 165 167
|   0   0   0   0 165 167   0 165 167   0   0 165 167   0   0   0   0   0 165 167
|   0   0   0   0 165 167   0 165 167   0   0 165 167   0   0   0   0   0 165 167
|   0   0   0   0 165 167   0 165 167   0   0 165 167   0   0 162 164   0 165 167
|   0   0   0   0 165 167   0 165 167   0   0 165 167   0   0 165 167   0 168 170
|   0   0   0   0 168 170   0 165 167   0   0 165 167   0   0 165 167   0   0   0
|   0   0   0   0   0   0   0 165 167   0   0 165 167   0   0 165 167   0   0   0
|   0   0   0   0   0   0   0 165 167   0   0 165 167   0   0 165 167   0   0   0
+--------------------------------------------------------------------------------

Background
+--------------------------------------------------------------------------------
|   0   0   0   0   0   0   0   0   0   0   0   0   0   0   0   0   0 162 163 163
|   0   0   0   0   0   0   0   0   0   0   0   0   0   0   0   0   0 165 166 166
|   0   0   0   0  89  90  91  89  91   0   0  89  91   0   0   0   0 165 166 166
|   0   0   0   0  95 114 115  92  94   0   0  92  94   0   0   0   0 165 166 166
|   0   0   0   0  92 116   0  89  91   0   0  89  91   0   0   0   0 168 169 169
|   0   0   0   0   0   0   0  92  94   0   0  92  94   0   0   0   0   0   0   0
|   0   0   0   0  89  91   0  89  91   0   0  89  91   0   0   0   0   0  89  91
|   0   0   0   0  92  94   0  92  94   0   0  92  94   0   0   0   0   0  92  94
|   0   0   0   0  89  91   0  89  91   0   0  89  91   0  89  90  91   0  89  91
|   0   0   0   0  92  94   0  92  94   0   0  92  94   0 123 124  97   0  92  94
|   0   0   0   0   0   0   0   0   0   0   0   0   0   0   0 125  94   0   0   0
|   0   0   0   0   0   0   0   0   0   0   0   0   0   0   0   0   0   0   0   0
|   0   0   0   0   0   0   0   0   0   0   0   0   0   0   0   0   0   0   0   0
+--------------------------------------------------------------------------------

Background
+--------------------------------------------------------------------------------
|   0   0   0   0   0   0   0   0   0   0   0   0   0   0   0   0   0   0   0   0
|   0   0   0   0   0   0   0   0   0   0   0   0   0   0   0   0   0   0  89  91
|   0   0   0   0   0   0   0   0   0   0   0   0   0   0   0   0   0   0  92  94
|   0   0   0   0   0   0   0   0   0   0   0   0   0   0   0   0   0   0  89  91
|   0   0   0   0   0   0   0   0   0   0   0   0   0   0   0   0   0   0  92  94
|   0   0   0   0   0   0   0   0   0   0   0   0   0   0   0   0   0   0   0   0
|   0   0   0   0   0   0   0   0   0   0   0   0   0   0   0   0   0   0   0   0
|   0   0   0   0   0   0   0   0   0   0   0   0   0   0   0   0   0   0   0   0
|   0   0   0   0   0   0   0   0   0   0   0   0   0   0   0   0   0   0   0   0
|   0   0   0   0   0   0   0   0   0   0   0   0   0   0   0   0   0   0   0   0
|   0   0   0   0   0   0   0   0   0   0   0   0   0   0   0   0   0   0   0   0
|   0   0   0   0   0   0   0   0   0   0   0   0   0   0   0   0   0   0   0   0
|   0   0   0   0   0   0   0   0   0   0   0   0   0   0   0   0   0   0   0   0
+--------------------------------------------------------------------------------

Background
+--------------------------------------------------------------------------------
|   0   0   0   0   0   0   0   0   0   0   0   0   0   0   0   0   0   0   0   0
|   0   0   0   0   0   0   0   0   0   0   0   0   0   0   0   0   0   0   0   0
|   0   0   0   0   0   0   0   0   0   0   0   0   0   0   0   0   0  89  91  89
|   0   0   0   0   0   0   0   0   0   0   0   0   0   0   0   0   0  92  94  92
|   0   0   0   0   0   0   0   0   0   0   0   0   0   0   0   0   0   0   0   0
|   0   0   0   0   0   0   0   0   0   0   0   0   0   0   0   0   0   0   0   0
|   0   0   0   0   0   0   0   0   0   0   0   0   0   0   0   0   0   0   0   0
|   0   0   0   0   0   0   0   0   0   0   0   0   0   0   0   0   0   0   0   0
|   0   0   0   0   0   0   0   0   0   0   0   0   0   0   0   0   0   0   0   0
|   0   0   0   0   0   0   0   0   0   0   0   0   0   0   0   0   0   0   0   0
|   0   0   0   0   0   0   0   0   0   0   0   0   0   0   0   0   0   0   0   0
|   0   0   0   0   0   0   0   0   0   0   0   0   0   0   0   0   0   0   0   0
|   0   0   0   0   0   0   0   0   0   0   0   0   0   0   0   0   0   0   0   0
+--------------------------------------------------------------------------------

Background
+--------------------------------------------------------------------------------
|   0   0   0   8   0   0   9   0   0   0   9   0   0   0   0   0   9   0   9   0
|   0   5   6   6   6   6   9   6   6   6   9   6   6   6   6   6   6   6   6   7
|   0   0   0   9   0   0   9   0   0   0   9   0   0   0   0   0  31  32  33   0
|   0   0   0   9   0   0   9   0   0   0   9   0   0   0   0   0   0   0   0   0
|   0   0   0   9   0   0   9   0   0   0   9   0   0   0   0   0   0   0   0   0
|   5   6   6   9   6   6   9   6   6   6   9   6   6   6   6   6   6   6   6   6
|   0   0   0   9   0   0   9   0   0   0   9   0   0   0   0   0   0   0   0   0
|   0   5   6   9   6   6   9   6   6   6   9   6   6   6   6   6   6   6   7   0
|   0   0   0  10   0   0   9   0   0   0   9   0   0   0   9   0   0   0   0   0
|   0   0   0   0   0   0   9   0   0   0   9   0   0   0   9   0   0  25 233  27
|   0   0   0   0   0   0   9   0   0   0   9   0   0   0   9   0   0   9   0   9
|   0   5   6   6   6   6   6   6   6   6   6   6   6   6   6   6   6   6   6   6
|   0   0   0   0   0   0   9   0   0   0   9   0   0   0   9   0   0   0   0   0
+--------------------------------------------------------------------------------

Background
+--------------------------------------------------------------------------------
|   0   0   0   0   0   0   0   0   0   0   0   0   0   0   0   0   0   0   0   0
|   0   0   0  34  35   0   0   0   0   0   0   0   0   0   0   0   0   0   0   0
|   0   0   0  36  37   0   0   0   0   0   0   0   0   0   0   0   0   8   0   0
|   0   0   0   0   0   0   5   6   6   6   6   6   6   6   7   0   0   9   0   0
|   0   0   0   0   0   0   0   0   0   0   0   0   0   0   0   0   0   9   0   0
|   0   0   0   0   0   0   0   0   0   0   0   0   0   0   0   0   0   9   0   0
|   0   0   0   0   0   0   0   0   0   0   0   0   0   0   0   0   0   9   0   0
|   0   0   0   0   0   0   0   0   0   0   0   0   0  46  47   0   0  10   0   0
|   0   0   0   0   0   0   0   0   0   0   0   0   0  48  49   0   0   0   0   0
|   0   0   0   0   0   0   0   0   0   0   0   0   0   0   0   0   0   0   0   0
|   0   0   0   0   0   0   0   0   0   0   0   0   0   0   0   0   0   0   0   0
|   0   0   0   0   0   0   0   0   0   0   0   0   0   0   0   0   0   0   0   0
|   0   0   0   0   0   0   0   0   0   0   0   0   0   0   0   0   0   0   0   0
+--------------------------------------------------------------------------------

Background
+--------------------------------------------------------------------------------
|   0   0   0   0   0   0   0   0   0   0   0   0   0   0   0   0   3   0   3   0
|   0   0   0   4   4   0   3   0   0   0   3   0   0   0   0   0   3   0   3   0
|   0   0   0   4   0   0   0   0   0   0   0   0   0   0   0   0   0   3   0   0
|   0   0   0   0   0   0   3   0   0   0   3   0   0   0   0   0   0   0   0   0
|   0   0   0   0   0   0   0   0   0   0   0   0   0   0   0   0   0   0   0   0
|   0   0   0   3   0   0   3   0   0   0   3   0   0   0   0   0   0   3   0   0
|   0   0   0   0   0   0   0   0   0   0   0   0   0   0   0   0   0   0   0   0
|   0   0   0   3   0   0   3   0   0   0   3   0   0   4   4   0   0   3   0   0
|   0   0   0   0   0   0   0   0   0   0   0   0   0   0   4   0   0   0   0   0
|   0   0   0   0   0   0   0   0   0   0   0   0   0   0   0   0   0   0   3   0
|   0   0   0   0   0   0   0   0   0   0   0   0   0   0   0   0   0   3   0   3
|   0   0   0   0   0   0   3   0   0   0   3   0   0   0   3   0   0   3   3   3
|   0   0   0   0   0   0   0   0   0   0   0   0   0   0   0   0   0   0   0   0
+--------------------------------------------------------------------------------
