#!/usr/bin/env pushover

Version
| 1

Name
| 072

Author
| Harry Nadler
| Avril Rigby
| Don Rigby
| Chris Waterworth

Theme
| mechanic

Time
| 3:00

Hint
| Lefthand side finishes last! Use the Bridges!

Level
+---------------------
|    1
|   __I __ ___ __
|
|   __!_ =_ =O? I?I_
|                 H
|    _II_ =_ =O? ?I_
|                 H
|     _II_ =OIIIAOH#
|                 H
|     ????_# ?O= ?A_
|                2H
|   #_???IIO_IIIA___
|
+---------------------

Background
+--------------------------------------------------------------------------------
|   1   1   1   1   1   1   1   1   1   1   1   1   1   1   1   1   1   1   1   1
|   1   1   1   1   1   1   1   1   1   1   1   1   1   1   1   1   1   1   1   1
|   1   1   1   1   1   1   1   1   1   1   1   1   1   1   1   1   1   1   1   1
|   1   1   1   1   1   1   1   1   1   1   1   1   1   1   1   1   1   1   1   1
|   1   1   1   1   1   1   1   1   1   1   1   1   1   1   1   1   1   1   1   1
|   1   1   1   1   1   1   1   1   1   1   1   1   1   1   1   1   1   1   1   1
|   1   1   1   1   1   1   1   1   1   1   1   1   1   1   1   1   1   1   1   1
|   1   1   1   1   1   1   1   1   1   1   1   1   1   1   1   1   1   1   1   1
|   1   1   1   1   1   1   1   1   1   1   1   1   1   1   1   1   1   1   1   1
|   1   1   1   1   1   1   1   1   1   1   1   1   1   1   1   1   1   1   1   1
|   1   1   1   1   1   1   1   1   1   1   1   1   1   1   1   1   1   1   1   1
|   1   1   1   1   1   1   1   1   1   1   1   1   1   1   1   1   1   1   1   1
|   1   1   1   1   1   1   1   1   1   1   1   1   1   1   1   1   1   1   1   1
+--------------------------------------------------------------------------------

Background
+--------------------------------------------------------------------------------
|   0   0   0  89  90  90  90  91   0   0   0   0   0   0   0   0   0   0   0   0
|   0   0   0  95  96  96  96  97   0   0   0   0   0   0   0  89  90  90 163 164
|   0   0   0  95  96  96  96  97   0   0   0   0   0   0   0  95  96  96 166 167
|   0   0   0  95  96  96  96  97   0   0   0   0   0   0   0  95  96  96  96  97
|   0   0   0  95  96  96  96  97   0   0   0   0   0   0   0  95  96  96  96  97
|   0   0   0  95  96  96  96  97   0   0   0   0   0   0   0  95  96  96  96  97
|   0   0   0  95  96  96  96  97   0   0   0   0   0   0   0  95  96  96  96  97
|   0   0   0  95  96  96  96  97   0   0   0   0   0   0   0  95  96  96  96  97
|   0   0   0  95  96  96  96  97   0   0   0   0   0   0   0  95  96  96  96  97
|   0   0   0  95  96  96  96  97   0   0   0   0   0   0   0  95  96  96  96  97
|   0   0   0  95  96  96  96  97   0   0   0   0   0   0   0  95  96  96  96  97
|   0   0   0  95  96  96  96  97   0   0   0   0   0   0   0  95  96  96  96  97
|   0   0   0  95  96  96  96  97   0   0   0   0   0   0   0  95  96  96  96  97
+--------------------------------------------------------------------------------

Background
+--------------------------------------------------------------------------------
|   0   0   0   0   0   0   0   0   0   0   0   0   0   0   0   0   0   0   0   0
|   0   0   0   0   0   0   0   0   0   0   0   0   0   0   0   0   0   0   0   0
|   0   0 162 163 163 163 163 163 163 163 163 163 163 163 163 163 163 164  89  91
|   0   0 168 169 169 169 169 169 169 169 169 169 169 169 169 169 169 170  92  94
|   0 162 163 163 163 163 163 163 163 163 163 163 163 163 163 163 163 163 163 163
|   0 168 169 169 169 169 169 169 169 169 169 169 169 169 169 169 169 169 169 169
|   0   0 162 163 163 163 163 163 163 163 163 163 163 163 163 163 163 163 163 163
|   0   0 168 169 169 169 169 169 169 169 169 169 169 169 169 169 169 169 169 169
|   0   0   0   0 162 163 163 163 163 163 163 163 163 163 163 163 163 163 163 163
|   0   0   0   0 168 169 169 169 169 169 169 169 169 169 169 169 169 169 169 169
|   0   0   0   0 162 163 163 163 163 163 163 163 163 163 163 163 163 163 163 163
|   0   0   0   0 168 169 169 169 169 169 169 169 169 169 169 169 169 169 169 169
|   0   0   0   0   0   0   0   0   0   0   0   0   0   0   0   0   0   0   0   0
+--------------------------------------------------------------------------------

Background
+--------------------------------------------------------------------------------
|   0   0   0   0   0   0   0   0   0   0   0   0   0   0   0   0   0   0   0   0
|   0   0   0   0   0   0   0   0   0   0   0   0   0   0   0   0   0  89  91   0
|   0   0   0   0   0   0   0   0   0   0   0   0   0   0   0   0   0  92  94   0
|   0   0   0   0   0   0   0   0   0   0   0   0   0   0   0   0   0   0   0   0
|   0   0   0   0   0   0   0   0   0   0   0   0   0   0   0   0   0   0   0   0
|   0   0   0   0   0   0   0   0   0   0   0   0   0   0   0   0   0   0   0   0
|   0   0   0   0   0   0   0   0   0   0   0   0   0   0   0   0   0   0   0   0
|   0   0   0   0   0   0   0   0   0   0   0   0   0   0   0   0   0   0   0   0
|   0   0   0   0   0   0   0   0   0   0   0   0   0   0   0   0   0   0   0   0
|   0   0   0   0   0   0   0   0   0   0   0   0   0   0   0   0   0   0   0   0
|   0   0   0   0   0   0   0   0   0   0   0   0   0   0   0   0   0   0   0   0
|   0   0   0   0   0   0   0   0   0   0   0   0   0   0   0   0   0   0   0   0
|   0   0   0   0   0   0   0   0   0   0   0   0   0   0   0   0   0   0   0   0
+--------------------------------------------------------------------------------

Background
+--------------------------------------------------------------------------------
|   0   0   0   0   0   0   0   0   0   0   0   0   0   0   0   0   0   0   0   0
|   0   0   0   0   0   0   0   0   0   0   0   0   0   0   0   0   0   0   0   0
|   0   0   0   0   0   0   0   0   0   0   0   0   0   0   0   0   0  89  91   0
|   0   0   0   0   0   0   0   0   0   0   0   0   0   0   0   0   0  92  94   0
|   0   0   0   0   0   0   0   0   0   0   0   0   0   0   0   0   0   0   0   0
|   0   0   0   0   0   0   0   0   0   0   0   0   0   0   0   0   0   0   0   0
|   0   0   0   0   0   0   0   0   0   0   0   0   0   0   0   0   0   0   0   0
|   0   0   0   0   0   0   0   0   0   0   0   0   0   0   0   0   0   0   0   0
|   0   0   0   0   0   0   0   0   0   0   0   0   0   0   0   0   0   0   0   0
|   0   0   0   0   0   0   0   0   0   0   0   0   0   0   0   0   0   0   0   0
|   0   0   0   0   0   0   0   0   0   0   0   0   0   0   0   0   0   0   0   0
|   0   0   0   0   0   0   0   0   0   0   0   0   0   0   0   0   0   0   0   0
|   0   0   0   0   0   0   0   0   0   0   0   0   0   0   0   0   0   0   0   0
+--------------------------------------------------------------------------------

Background
+--------------------------------------------------------------------------------
|   0   0 235   0  28  30   0   0   0   0   0   0   0   0  25  26  26  27   0   0
|   0   0  28   2   2  30   0   0   0   0   0   0   0   0  28   2   2  30   0   0
|   0   0  28   2   2  30   0   0   0   0   0   0   0   0  28   2   2  30   0   0
|   0   0  28   2   2  30   0   0   0   0   0   0   0   0  28   2   2  30   0   0
|   0   0  28   2   2  30   0   0   0   0   0   0   0   0  28   2   2  30   0   0
|   0   0  28   2   2  30   0   0   0   0   0   0   0   0  28   2   2  30   0   0
|   0   0  28   2   2  30   0   0   0   0   0   0   0   0  28   2   2  30   0   0
|   0   0  28   2   2  30   0   0   0   0   0   0   0   0  28   2   2  30   0   0
|   0   0  28   2   2  30   0   0   0   0   0   0   0   0  28   2   2  30   0   0
|   0   0  28   2   2  30   0   0   0   0   0   0   0   0  28  32   2  30   0   0
|   0   0  28   2   2  30   0   0   0   0   0   0   0   0 235   0  28  30   0   0
|   0   0  28   2   2  30   0   0   0   0   0   0   0   0  28  26   2  30   0   0
|   0   0  28   2   2  30   0   0   0   0   0   0   0   0  28   2   2  30   0   0
+--------------------------------------------------------------------------------

Background
+--------------------------------------------------------------------------------
|   0   0   0   0   0   0   0   0   0   0   0   0   0   0   0   0   0   0   0   0
|   0   5   6   6   6   6   6   6   6   6   6   6   6   6   6   7   0   0   0   0
|   0   0   0   0   0   0   0   0   0   0   0   0   0   0   0   0   0   0   0   0
|   5   6   6   6   6   6   6   6   6   6   6   6   6   6   6   6   6   6   7   0
|   0   0   0   0   0   0   0   0   0   0   0   0   0   0   0   0   0   0   0   0
|   0   5   6   6   6   6   6   6   6   6   6   6   6   6   6   6   6   6   7   0
|   0   0   0   0   0   0   0   0   0   0   0   0   0   0   0   0   0   0   0   0
|   0   0   0   5   6   6   6   6   6   6   6   6   6   6   6   6   6   6   6   7
|   0   0   0   0   0   0   0   0   0   0   0   0   0   0   0   0   0   0   0   0
|   0   0   0   5   6   6   6   6   6   6   6   6   6   6   6   6   6   6   7   0
|   0   0   0   0   0   0   0   0   0   0   0   0   0   0   0   0   0   0   0   0
|   0   5   6   6   6   6   6   6   6   6   6   6   6   6   6   6   6   6   7   0
|   0   0   0   0   0   0   0   0   0   0   0   0   0   0   0   0   0   0   0   0
+--------------------------------------------------------------------------------

Background
+--------------------------------------------------------------------------------
|   0   0   3   0   0   3   0   0   0   0   0   0   0   0   0   3   3   0   0   0
|   0   0   3   3   3   3   0   0   0   0   0   0   0   0   3   3   0   3   0   0
|   0   0   0   0   0   3   0   0   0   0   0   0   0   0   0   0   0   3   0   0
|   0   0   3   3   3   3   0   0   0   0   0   0   0   0   3   3   3   3   0   0
|   0   0   0   0   0   3   0   0   0   0   0   0   0   0   0   0   0   3   0   0
|   0   0   3   3   3   3   0   0   0   0   0   0   0   0   3   3   3   3   0   0
|   0   0   0   0   0   3   0   0   0   0   0   0   0   0   0   0   0   3   0   0
|   0   0   3   3   3   3   0   0   0   0   0   0   0   0   3   3   3   3   0   0
|   0   0   3   0   0   3   0   0   0   0   0   0   0   0   0   0   0   3   0   0
|   0   0   0   3   3   3   0   0   0   0   0   0   0   0   3   3   3   3   0   0
|   0   0   3   0   0   3   0   0   0   0   0   0   0   0   0   0   0   3   0   0
|   0   0   3   3   3   3   0   0   0   0   0   0   0   0   3   3   3   3   0   0
|   0   0   0   0   0   3   0   0   0   0   0   0   0   0   0   0   0   3   0   0
+--------------------------------------------------------------------------------
