#!/usr/bin/env pushover

Version
| 1

Name
| 076

Author
| Harry Nadler
| Avril Rigby
| Don Rigby
| Chris Waterworth

Theme
| mechanic

Time
| 2:00

Hint
| You'll have to put that Yellow in the run somewhere!

Level
+---------------------
|                  1
|               OII_
|
|   #_*?_________#__
|
|   _*_________#___#
|
|   #______I______*#
|    2
|   #_______  _*___#
|        H
|   #IIIII?______?!_
|
+---------------------

Background
+--------------------------------------------------------------------------------
|   1   1   1   1   1   1   1   1   1   1   1   1   1   1   1   1   1   1   1   1
|   1   1   1   1   1   1   1   1   1   1   1   1   1   1   1   1   1   1   1   1
|   1   1   1   1   1   1   1   1   1   1   1   1   1   1   1   1   1   1   1   1
|   1   1   1   1   1   1   1   1   1   1   1   1   1   1   1   1   1   1   1   1
|   1   1   1   1   1   1   1   1   1   1   1   1   1   1   1   1   1   1   1   1
|   1   1   1   1   1   1   1   1   1   1   1   1   1   1   1   1   1   1   1   1
|   1   1   1   1   1   1   1   1   1   1   1   1   1   1   1   1   1   1   1   1
|   1   1   1   1   1   1   1   1   1   1   1   1   1   1   1   1   1   1   1   1
|   1   1   1   1   1   1   1   1   1   1   1   1   1   1   1   1   1   1   1   1
|   1   1   1   1   1   1   1   1   1   1   1   1   1   1   1   1   1   1   1   1
|   1   1   1   1   1   1   1   1   1   1   1   1   1   1   1   1   1   1   1   1
|   1   1   1   1   1   1   1   1   1   1   1   1   1   1   1   1   1   1   1   1
|   1   1   1   1   1   1   1   1   1   1   1   1   1   1   1   1   1   1   1   1
+--------------------------------------------------------------------------------

Background
+--------------------------------------------------------------------------------
|   0   0   0   0   0   0   0   0   0   0   0   0   0   0   0   0   0   0   0   0
|   0   0   0   0   0   0   0 162 164 162 164   0   0 162 164 162 164   0   0   0
|   0   0   0   0 162 164   0 165 167 165 167   0   0 165 167 165 167   0 162 164
|   0   0   0   0 165 167   0 165 167 165 167   0   0 165 167 165 167   0 165 167
|   0   0   0   0 165 167   0 165 167 165 167   0   0 165 167 165 167   0 165 167
|   0   0   0   0 165 167   0 165 167 165 167   0   0 165 167 165 167   0 165 167
|   0   0   0   0 165 167   0 165 167 165 167   0   0 165 167 165 167   0 165 167
|   0   0   0   0 165 167   0 165 167 165 167   0   0 165 167 165 167   0 165 167
|   0   0   0   0 165 167   0 165 167 165 167   0   0 165 167 165 167   0 165 167
|   0   0   0   0 165 167   0 165 167 165 167   0   0 165 167 165 167   0 165 167
|   0   0   0   0 165 167   0 165 167 165 167   0   0 165 167 165 167   0 165 167
|   0   0   0   0 165 167   0 165 167 165 167   0   0 165 167 165 167   0 165 167
|   0   0   0   0 165 167   0 165 167 165 167   0   0 165 167 165 167   0 165 167
+--------------------------------------------------------------------------------

Background
+--------------------------------------------------------------------------------
|   0   0   0   0   0   0   0   0   0   0   0   0   0   0   0   0   0   0   0   0
|   0   0   0   0   0   0   0   0   0   0   0   0   0   0   0   0   0   0   0   0
|   0   0   0   0 162 163 163 163 163 163 163 163 163 163 163 163 163 163 163 163
|   0   0   0   0 168 169 169 169 169 169 169 169 169 169 169 169 169 169 169 169
|   0   0   0   0   0   0   0   0   0   0   0   0   0   0   0   0   0   0   0   0
|   0   0   0   0   0   0   0   0   0   0   0   0   0   0   0   0   0   0   0   0
|   0   0   0   0   0   0   0   0   0   0   0   0   0   0   0   0   0   0   0   0
|   0   0   0 162 163 163 164   0   0   0   0   0 162 163 163 163 163 163 163 163
|   0   0   0 165 166 166 167   0   0   0   0   0 165 166 166 166 166 166 166 166
|   0   0   0 165 166 166 167   0   0   0   0   0 165 166 166 166 166 166 166 166
|   0   0   0 165 166 166 167   0   0   0   0   0 165 166 166 166 166 166 166 166
|   0   0   0 165 166 166 167   0   0   0   0   0 165 166 166 166 166 166 166 166
|   0   0   0 168 169 169 170   0   0   0   0   0 168 169 169 169 169 169 169 169
+--------------------------------------------------------------------------------

Background
+--------------------------------------------------------------------------------
|   0   0   0   0   0   0   0   0   0   0   0   0   0   0   0   0   0 162 163 163
|   0   0   0   0   0   0   0   0   0   0   0   0   0   0   0   0   0 165 166 166
|   0   0   0   0  89  90  91  89  91  89  91  89  91  89  91  89  91 165 166 166
|   0   0   0   0  95 114 115  92  94  92  94  92  94  92  94  92  94 165 166 166
|   0   0   0   0  92 116   0   0   0   0   0   0   0   0   0   0   0 168 169 169
|   0   0   0   0   0   0   0   0   0   0   0   0   0   0   0   0   0   0   0   0
|   0   0   0   0   0   0   0   0   0   0   0   0   0   0   0   0   0   0   0   0
|   0   0   0   0  89  91   0   0   0   0   0   0   0   0   0   0   0   0   0   0
|   0   0   0   0  92  94   0   0   0   0   0   0   0   0   0   0   0   0   0  89
|   0   0   0  89  91  89  91   0   0   0   0   0   0   0   0   0   0   0   0  92
|   0   0   0  92  94  92  94   0   0   0   0   0   0   0   0   0   0   0   0  89
|   0   0   0   0   0   0   0   0   0   0   0   0   0   0   0   0   0   0   0  92
|   0   0   0   0   0   0   0   0   0   0   0   0   0   0   0   0   0   0   0   0
+--------------------------------------------------------------------------------

Background
+--------------------------------------------------------------------------------
|   0   0   0   0   0   0   0   0   0   0   0   0   0   0   0   0   0   0   0   0
|   0   0   0   0   0   0   0   0   0   0   0   0   0   0   0   0   0   0   0  89
|   0   0   0   0   0   0   0   0   0   0   0   0   0   0   0   0   0   0   0  92
|   0   0   0   0   0   0   0   0   0   0   0   0   0   0   0   0   0   0  89  91
|   0   0   0   0   0   0   0   0   0   0   0   0   0   0   0   0   0   0  92  94
|   0   0   0   0   0   0   0   0   0   0   0   0   0   0   0   0   0   0   0   0
|   0   0   0   0   0   0   0   0   0   0   0   0   0   0   0   0   0   0   0   0
|   0   0   0   0   0   0   0   0   0   0   0   0   0   0   0   0   0   0   0   0
|   0   0   0  89  91  89  91   0   0   0   0   0   0   0   0   0   0   0   0   0
|   0   0   0  92  94  92  94   0   0   0   0   0   0   0   0   0   0   0   0  89
|   0   0   0  89  91  89  91   0   0   0   0   0   0   0   0   0   0   0   0  92
|   0   0   0  92  94  92  94   0   0   0   0   0   0   0   0   0   0   0   0   0
|   0   0   0   0   0   0   0   0   0   0   0   0   0   0   0   0   0   0   0   0
+--------------------------------------------------------------------------------

Background
+--------------------------------------------------------------------------------
|   0   0   0   0   0   0   0   0   0   0   0   0   0   0   0   0   0   0   0   0
|   0   0   0   0   0   0   0   0   0   0   0   0   0   0   0   0   0   0   0   0
|   0   0   0   0   0   0   0   0   0   0   0   0   0   0   0   0   0  89  91  89
|   0   0   0   0   0   0   0   0   0   0   0   0   0   0   0   0   0  92  94  92
|   0   0   0   0   0   0   0   0   0   0   0   0   0   0   0   0   0   0   0   0
|   0   0   0   0   0   0   0   0   0   0   0   0   0   0   0   0   0   0   0   0
|   0   0   0   0   0   0   0   0   0   0   0   0   0   0   0   0   0   0   0   0
|   0   0   0   0   0   0   0   0   0   0   0   0   0   0   0   0   0   0  89  91
|   0   0   0   0   0   0   0   0   0   0   0   0   0   0   0   0   0   0  92  94
|   0   0   0   0  89  91   0   0   0   0   0   0   0   0   0   0   0   0  89  91
|   0   0   0   0  92  94   0   0   0   0   0   0   0   0   0   0   0   0  92  94
|   0   0   0   0   0   0   0   0   0   0   0   0   0   0   0   0   0   0  89  91
|   0   0   0   0   0   0   0   0   0   0   0   0   0   0   0   0   0   0  92  94
+--------------------------------------------------------------------------------

Background
+--------------------------------------------------------------------------------
|   0   0   0   0   0   0   0   0   0   0   0   0   0   0   0   0   0   0   0   0
|   0   0   0   0   0   0   0   0   0   0   0   0   0   0   0   0   0   0   0   0
|   0   0   0   0   0   0   0   0   0   0   0   0   0   0   0   0   0   0  89  91
|   0   0   0   0   0   0   0   0   0   0   0   0   0   0   0   0   0   0  92  94
|   0   0   0   0   0   0   0   0   0   0   0   0   0   0   0   0   0   0   0   0
|   0   0   0   0   0   0   0   0   0   0   0   0   0   0   0   0   0   0   0   0
|   0   0   0   0   0   0   0   0   0   0   0   0   0   0   0   0   0   0   0   0
|   0   0   0   0   0   0   0   0   0   0   0   0   0   0   0   0   0   0   0   0
|   0   0   0   0   0   0   0   0   0   0   0   0   0   0   0   0   0   0  89  91
|   0   0   0   0   0   0   0   0   0   0   0   0   0   0   0   0   0   0  92  94
|   0   0   0   0   0   0   0   0   0   0   0   0   0   0   0   0   0   0  89  91
|   0   0   0   0   0   0   0   0   0   0   0   0   0   0   0   0   0   0  92  94
|   0   0   0   0   0   0   0   0   0   0   0   0   0   0   0   0   0   0   0   0
+--------------------------------------------------------------------------------

Background
+--------------------------------------------------------------------------------
|   0   0   0   0   0   0   8   0   8   0   0   0   0   0   0   0 235   0 236   0
|   0   0   0   0   0   0   9   0   9   0   0   0   0   0   0   0  28  26  30   0
|   0   0   0   0   0   0   9   0   9   0   0   0   0   0   0   0  31  32  33   0
|   0   0   0   0   0   0   9   0   9   0   0   0   0   0   0   0   0   0   0   0
|   0   0   0   0   0   0   9   0   9   0   0   0   0   0   0   0   0   0   0   0
|   0   0   0   0   0   0   9   0   9   0   0   0   0   0   0   0   0   0   0   0
|   0   0  25  26  27   0   9   0   9   0   0  25  26  26  26  26  26  26  27   0
|   0   0  28  32  30   0   9   0   9   0   0  28   2   2   2   2   2   2  30   0
|   0   0 235   0 236   0   9   0   9   0   0  28  29   2  29   2   2  29  30   0
|   0   0  28  26  30   0   9   0   9   0   0  28   2   2   2   2   2   2  30   0
|   0   0  31  32  33   0   9   0   9   0   0  31  32  32  32  32  32  32  33   0
|   0   0   0   0   0   0   9   0   9   0   0   0   0   0   0   0   0   0   0   0
|   0   0   0   0   0   0   9   0   9   0   0   0   0   0   0   0   0   0   0   0
+--------------------------------------------------------------------------------

Background
+--------------------------------------------------------------------------------
|   0   0   0   0   0   0   0   0   0   0   0   0   8   0   8   0   0   0   0   0
|   0   0   0   8   0   0   0   0   0   0   0   0   9   0   9   0   0   0   0   0
|   0   0   0   9   0   0   0   0   0   0   0   0   9   0   9   0   0   8   0   0
|   0   0   0   9   0   0   0   0   0   0   0   0   9   0   9   0   0   9   0   0
|   0   0   0   9   0   0   0   0   0   0   0   0   9   0   9   0   0   9   0   0
|   0   0   0   9   0   0   0   0   0   0   0   0   9   0   9   0   0   9   0   0
|   0   0   0  10   0   0   0   0   0   0   0   0  10   0  10   0   0  10   0   0
|   0   0   0   0   0   0   0   0   0   0   0   0   0   0   0   0   0   0   0   0
|   0   0   0   0   0   0   0   0   0   0   0   0   0   0   0   0   0   0   0   0
|   0   0   0   0   0   0   0   0   0   0   0   0   0   0   0   0   0   0   0   0
|   0   0   0   8   0   0   0   0   0   0   0   0   8   0   8   0   0   8   0   0
|   0   0   0   9   0   0   0   0   0   0   0   0   9   0   9   0   0   9   0   0
|   0   0   0   9   0   0   0   0   0   0   0   0   9   0   9   0   0   9   0   0
+--------------------------------------------------------------------------------

Background
+--------------------------------------------------------------------------------
|   0   0   0   0   0   0   0   0   0   0   0   0   0   0   0   0   0   0   0   0
|   0   0   0   0   5   6   6   6   6   6   6   6   6   6   6   6   6   6   7   0
|   0   0   0   0   0   0   0   0   0   0   0   0   0   0   0   0   0   0   0   0
|   0   0   0   0   0   0   0   0   0   0   0   0   0   0   0   0   0   0   0   0
|   0   0   0   0   0   0   0   0   0   0   0   0   0   0   0   0   0   0   0   0
|   0   0   0   0   0   0   0   0   0   0   0   0   0   0   0   0   0   0   0   0
|   0   0   0   0   0   0   0   0   0   0   0   0   0   0   0   0   0   0   0   0
|   0   0   0   0   0   0   0   0   0   0   0   0   0   0   0   0   0   0   0   0
|   0   0   0   0   0   0   0   0   0   0   0   0   0   0   0   0   0   0   0   0
|   0   0   0   0   0   0   0   0   0   0   0   0   0   0   0   0   0   0   0   0
|   0   0   0   0   0   0   0   0   0   0   0   0   0   0   0   0   0   0   0   0
|   0   0   0   0   0   0   0   0   0   0   0   0   0   0   0   0   0   0   0   0
|   0   0   0   0   0   0   0   0   0   0   0   0   0   0   0   0   0   0   0   0
+--------------------------------------------------------------------------------

Background
+--------------------------------------------------------------------------------
|   0   0   0   0   0   0   0   0   0   0   0   0   0   0   0   0   0   0   0   0
|   0   0   0  34  35   0   0   0   0   0   0   0   0   0   0   0   0   0   0   0
|   0   0   0  36  37   0   0   0   0   0   0   0   0   0   0   0   0   0   0   0
|   0   0   0   0   0   0   0   0   0   0   0   0   0   0   0   0   0   0   0   0
|   0   0   0   0   0   0   0   0   0   0   0   0   0   0   0   0   0   0   0   0
|   0   0   0   0   0   0   0   0   0   0   0   0   0   0   0   0   0   0   0   0
|   0   0   0   0   0   0   0   0   0   0   0   0   0   0   0   0   0   0   0   0
|   0   0   0   0   0   0   0   0   0   0   0   0   0   0   0   0   0   0   0   0
|   0   0   0   0   0   0   0   0   0   0   0   0   0   0   0   0   0   0   0   0
|   0   0   0   0   0   0   0   0   0   0   0   0   0   0   0   0   0   0   0   0
|   0   0   0   0   0   0   0   0   0   0   0   0   0   0   0   0   0   0   0   0
|   0   0   0   0   0   0   0   0   0   0   0   0   0   0   0   0   0   0   0   0
|   0   0   0   0   0   0   0   0   0   0   0   0   0   0   0   0   0   0   0   0
+--------------------------------------------------------------------------------

Background
+--------------------------------------------------------------------------------
|   0   0   0   0   0   0   0   0   0   0   0   0   0   0   0   0   3   0   3   0
|   0   0   0   4   4   0   3   0   3   0   3   0   3   0   3   0   3   3   3   0
|   0   0   0   4   0   0   0   0   0   0   0   0   0   0   0   0   0   3   0   0
|   0   0   0   0   0   0   0   0   0   0   0   0   0   0   0   0   0   0   0   0
|   0   0   0   0   0   0   0   0   0   0   0   0   0   0   0   0   0   0   0   0
|   0   0   0   0   0   0   0   0   0   0   0   0   0   0   0   0   0   0   0   0
|   0   0   0   3   0   0   0   0   0   0   0   0   3   3   3   3   3   3   0   0
|   0   0   3   0   3   0   0   0   0   0   0   3   0   0   0   0   0   0   3   0
|   0   0   3   0   3   0   0   0   0   0   0   3   3   0   3   0   0   3   3   0
|   0   0   3   0   3   0   0   0   0   0   0   3   0   0   0   0   0   0   3   0
|   0   0   0   3   0   0   0   0   0   0   0   0   3   3   3   3   3   3   0   0
|   0   0   0   0   0   0   0   0   0   0   0   0   0   0   0   0   0   0   0   0
|   0   0   0   0   0   0   0   0   0   0   0   0   0   0   0   0   0   0   0   0
+--------------------------------------------------------------------------------
